2 2 2 2 2 2 2 2 2 2 2 8 8 3 3 3 3 6 3 3 3 6 3 3 3 6 3 3 3 3 1 6 6 6 6 6 6 6 6 6
2 2 2 2 2 2 2 8 8 8 8 8 3 3 6 3 6 6 6 6 3 3 6 3 0 0 0 6 6 6 1 0 0 0 0 0 0 0 0 6
2 2 2 2 2 2 8 8 8 3 3 3 0 0 0 3 7 3 0 0 0 0 0 0 0 0 0 0 0 6 1 0 5 0 5 0 0 0 0 6
2 2 2 2 2 8 8 8 7 3 6 0 0 6 0 0 6 0 0 0 0 0 0 0 0 0 0 0 0 0 0 0 0 0 0 0 2 2 0 6
2 2 2 8 8 8 8 0 0 0 0 0 0 3 3 0 0 0 0 0 0 0 0 0 0 0 0 0 0 0 0 0 0 0 2 2 2 2 0 6
2 2 2 8 8 0 0 0 3 6 0 3 0 0 0 0 0 3 0 0 0 0 0 0 0 0 0 0 0 0 1 0 0 0 2 0 0 0 0 6
2 2 2 2 8 0 0 0 0 6 0 7 6 0 6 6 0 0 0 0 0 0 0 0 0 0 0 0 0 0 1 0 0 0 0 0 0 6 6 6
2 2 8 8 8 0 3 6 0 0 0 0 3 0 0 6 0 3 0 0 0 0 0 0 0 0 0 0 0 0 1 1 1 1 1 1 1 1 1 1
2 8 8 6 3 0 0 0 0 3 3 0 0 0 3 7 0 0 6 0 0 0 0 0 0 0 0 0 0 0 0 0 0 0 0 0 0 0 3 3
8 8 3 3 6 0 3 7 0 0 0 0 6 0 0 0 0 0 0 0 0 0 0 0 0 0 0 0 0 0 0 0 0 0 0 0 0 0 6 3
8 3 7 0 0 0 0 0 0 3 0 6 6 6 0 3 0 0 0 0 0 0 0 0 0 0 0 0 0 0 0 0 0 0 0 0 0 3 3 3
8 3 0 0 0 3 6 0 3 7 0 3 0 0 0 0 0 0 0 0 0 0 0 0 0 0 0 0 0 4 4 4 4 4 0 0 0 0 3 6
8 0 0 3 0 0 6 0 0 0 0 0 0 0 0 0 0 0 0 0 0 0 0 0 0 0 0 0 4 4 6 6 6 4 4 0 0 0 6 3
3 0 0 0 0 0 0 0 0 0 0 0 0 0 0 8 8 0 0 0 0 0 0 0 0 0 0 4 4 0 0 9 6 6 4 4 0 0 0 6
8 0 0 0 0 0 0 0 0 0 0 0 0 8 8 2 2 8 0 0 0 0 0 0 0 0 0 0 0 0 0 0 9 6 6 4 0 0 0 6
3 0 0 0 0 0 0 0 0 0 0 0 8 2 2 2 2 2 8 0 0 0 0 0 0 0 0 0 0 0 0 9 5 6 9 4 0 0 0 3
8 0 0 0 0 0 0 0 0 0 0 8 2 2 2 2 2 2 2 8 0 0 0 0 0 0 0 0 4 4 6 6 6 6 4 4 0 0 6 3
8 0 0 0 0 0 0 0 0 0 8 2 2 2 2 2 2 8 8 6 0 0 0 0 0 0 0 0 0 4 4 4 4 4 4 0 0 0 3 6
3 0 0 0 0 0 0 0 0 8 2 2 2 2 2 2 8 6 0 0 0 0 0 0 0 0 0 0 0 0 0 0 0 0 0 0 0 0 3 6
3 0 0 0 0 0 0 0 0 0 8 2 2 2 2 8 3 0 0 0 0 0 0 0 0 0 0 0 0 0 0 0 0 0 0 0 0 0 3 6
8 0 0 0 0 0 0 0 0 0 0 8 8 8 8 0 0 0 0 0 0 0 0 0 0 0 0 0 0 0 0 0 0 0 0 0 0 0 6 3
3 0 0 0 0 0 0 0 0 0 0 0 0 0 0 0 0 0 0 0 0 0 0 0 0 0 0 0 0 0 0 0 0 0 0 0 0 0 6 3
8 0 0 0 0 0 0 0 0 0 3 0 0 0 0 0 0 0 0 0 0 0 0 0 0 0 0 0 0 6 3 0 0 0 0 0 0 3 6 6
8 0 0 3 6 0 3 0 3 0 0 3 0 0 0 0 0 0 0 0 0 0 0 0 0 0 0 0 0 0 0 3 0 3 0 3 0 3 3 3
8 8 0 0 3 0 0 0 0 3 0 7 0 0 0 0 0 0 0 0 0 0 0 0 0 0 0 0 3 6 0 0 0 0 0 3 0 6 6 8
2 8 0 0 0 0 3 0 3 0 0 0 0 3 0 0 0 0 0 0 0 0 0 0 0 0 0 0 0 0 0 3 0 3 0 0 0 3 6 8
2 2 8 3 0 3 0 0 0 0 3 0 3 7 0 3 0 0 0 0 0 0 0 0 0 0 0 6 0 3 7 0 0 0 6 0 7 3 6 8
2 2 2 8 0 0 3 0 3 0 0 0 0 0 0 0 0 0 0 0 0 0 0 0 0 0 6 0 0 0 3 0 6 0 0 0 3 3 8 8
2 2 8 8 6 0 6 0 3 3 0 6 0 3 0 3 6 0 0 0 0 0 0 0 6 7 3 0 3 0 0 0 0 6 3 0 0 6 8 8
2 8 8 0 3 0 0 0 0 3 0 0 0 0 0 0 3 0 0 0 0 0 0 0 0 3 0 0 0 6 0 3 0 6 0 0 3 6 8 8
8 8 0 6 7 3 0 3 0 0 0 6 6 0 6 0 0 0 0 0 0 0 0 3 0 0 0 3 0 3 0 0 0 0 3 0 0 3 8 8
2 8 8 6 7 7 0 0 0 3 0 0 6 0 3 3 0 3 7 0 0 0 0 0 0 6 0 0 0 0 0 0 6 0 6 0 7 3 8 8
2 2 8 8 0 0 3 0 0 0 0 0 0 0 0 0 0 0 0 0 0 0 0 0 7 3 0 3 3 0 0 7 3 0 0 0 0 6 8 8
2 2 2 8 8 7 7 3 0 3 3 0 3 6 0 6 3 3 0 0 0 0 0 0 0 0 0 0 6 3 0 0 0 7 0 3 0 3 8 8
2 2 2 2 8 8 0 0 0 0 0 0 0 6 0 0 0 3 0 0 0 0 0 0 0 0 3 0 0 0 0 3 0 0 0 0 0 8 8 2
2 2 2 2 2 2 8 8 3 6 0 3 0 0 7 0 0 0 0 0 0 0 0 0 0 0 7 0 3 3 0 6 3 0 6 8 8 2 2 2
2 2 2 2 2 2 8 8 8 7 0 6 3 0 0 0 0 8 8 8 8 8 0 0 0 6 0 0 6 0 0 0 0 0 8 8 2 2 2 2
2 2 2 2 2 2 2 2 8 8 8 0 0 0 3 0 8 8 2 2 2 8 8 0 0 0 0 0 0 0 7 6 0 8 2 2 2 2 2 2
2 2 2 2 2 2 2 2 2 2 8 8 8 8 8 8 8 2 2 2 2 2 2 8 8 8 8 8 8 8 8 8 8 2 2 2 2 2 2 2
2 2 2 2 2 2 2 2 2 2 2 2 2 2 2 2 2 2 2 2 2 2 2 2 2 2 2 2 2 2 2 2 2 2 2 2 2 2 2 2